########################################################################################################################
#                                                                                      |         |                     #
#                                                                                      |    C    |                     #
#                                                                                      |         |                     #
...............................................                                        |---------|                     #
                                              .                                        .         .                     #
                                              .                                        .         .                     #
                                              .                                        .         .                     #
.....................................         .                                        .         .                     #
#                                   .         .                                        .         .                     #
#                                   .         .                                        .         .                     #
#                                   .         .                                        .         .                     #
#                                   .         .                                        .         .                     #
#                                   .         .                                        .         .                     #
#                                   .         .                                        .         .                     #
#                                   .         .                                        .         .                     #
#                                   .         .                                        .         .                     #
#                                   .         .                                        .         .                     #
#                                   .         .                                        .         .                     #
#                ....................         .                                        .         .                     #
#                .                            .                                        .         .                     #
#                .                            .                                        .         .                     #
#                .                            .                                        .         .                     #
#                .         ....................                                        .         .                     #
#                .         .                                                           .         .                     #
#                .         .                                                           .         .                     #
#                .         .                                                           .         .                     #
#                .         .                                                           .         .                     #
#                .         .                                                           .         .                     #
#                .         .                                                           .         .                     #
#                .         .............................................................         .                     #
#                .                                                                               .                     #
#                .                                                                               .                     #
#                .                                                                               .                     #
#                .................................................................................                     #                                                                              #
#                                                                                                                      #
#                                                                                                                      #
#                                                                                                                      #
#                                                                                                                      #
########################################################################################################################
